Unlimited Edition|2ED|
Revised Edition|3ED|
Fourth Edition|4ED|
Fifth Dawn|5DN|
Fifth Edition|5ED|
Classic Sixth Edition|6ED|
Seventh Edition|7ED|
Eighth Edition|8ED|
Tenth Edition|10E|
Alliances|ALL|
Apocalypse|APC|
Alara Reborn|ARB|
Arabian Nights|ARN|
Anthologies|ATH|
Antiquities|ATQ|
Archenemy|ARC|
Avacyn Restored|AVR|
Betrayers of Kamigawa|BOK|
Battle Royale Box Set|BRB|
Beatdown Box Set|BTD|
Champions of Kamigawa|CHK|
Chronicles|CHR|
Conflux|CON|
Coldsnap|CSP|
Dark Ascension|DKA|
Darksteel|DST|
Dissension|DIS|
Deckmasters|DKM|
Dragon's Maze|DGM|
The Dark|DRK|
Duel Decks: Divine vs. Demonic|DDC|
Duel Decks: Elspeth vs. Tezzeret|DDF|
Duel Decks: Elves vs. Goblins|EVG|
Duel Decks: Garruk vs. Liliana|DDD|
Duel Decks: Jace vs. Chandra|DD2|
Duel Decks: Phyrexia vs. the Coalition|DDE|
Duel Decks: Heroes vs. Monsters|DDL|
Eventide|EVE|
Exodus|EXO|
Fallen Empires|FEM|
Future Sight|FUT|
From the Vault: Dragons|FVD|
From the Vault: Exiled|FVE|
From the Vault: Relics|FVR|
Gatecrash|GTC|
Guildpact|GPT|
Homelands|HML|
Planechase|HOP|
Planechase 2012 Edition|PC2|
Ice Age|ICE|
Innistrad|ISD|
Invasion|INV|
Judgment|JUD|
Limited Edition Alpha|LEA|
Limited Edition Beta|LEB|
Legends|LEG|
Legions|LGN|
Lorwyn|LRW|
Magic 2010|M10|
Magic 2011|M11|
Magic 2012|M12|
Magic 2013|M13|
Magic 2014|M14|
Magic: The Gathering-Commander|CMD|
Masters Edition II|ME2|
Masters Edition III|ME3|
Masters Edition IV|ME4|
Masters Edition|MED|
Mirage|MIR|
Mercadian Masques|MMQ|
Morningtide|MOR|
Modern Masters|MMA|
Mirrodin|MRD|
Mirrodin Besieged|MBS|
MTGO Vanguard|VGO|
New Phyrexia|NPH|
Ninth Edition|9ED|
Nemesis|NMS|
Odyssey|ODY|
Onslaught|ONS|
Portal Second Age|PO2|
Prophecy|PCY|
Planar Chaos|PLC|
Planeshift|PLS|
Portal|POR|
Portal Three Kingdoms|PTK|
Premium Deck Series: Fire and Lightning|PD2|
Premium Deck Series: Slivers|PDS|
Ravnica: City of Guilds|RAV|
Return to Ravnica|RTR|
Rise of the Eldrazi|ROE|
Scars of Mirrodin|SOM|
Scourge|SCG|
Shadowmoor|SHM|
Shards of Alara|ALA|
Saviors of Kamigawa|SOK|
Starter 2000|S00|
Starter 1999|S99|
Stronghold|STH|
Tempest|TMP|
Theros|THS|
Torment|TOR|
Time Spiral|TSP|
Time Spiral "Timeshifted"|TSB|
Unglued|UGL|
Unhinged|UNH|
Urza's Destiny|UDS|
Urza's Legacy|ULG|
Urza's Saga|USG|
Vanguard Set 1|VG1|
Vanguard Set 2|VG2|
Vanguard Set 3|VG3|
Vanguard Set 4|VG4|
Visions|VIS|
Weatherlight|WTH|
Worldwake|WWK|
Zendikar|ZEN|